
WWWWWWWWWWWWWWWWWWWWWWWWWWWWWWWWWWWWWWWWWWWWWWWWWW
WBMBBBBBBBBBBBWBBBBBBBBBIIBBBBBBBBBWBBBBBBBBBBBZIW
WBBBBBBBBBBBBBWBBBBBBBBBBBBBBBBBBBBWBBBBBBBBBBBZZW
WBBBBBBBBBBBBBW       X            WBBBBBBBBBBBBBW
WBBBBBBBBBBBBBWBBBBBBBBBBBBBBBBBBBBWBBBBBBBBBBBBBW
WBBBBBBBBBBBBBBBBBBBBBBBBBBBBBBBBBBBBBBBBBBBBBBBBW
WBBBBBBBBBBBBBBBBBBBBBBBBBBBBBBBBBBBBBBBBBBBBBBBBW
WBBBBBBBBBBBBBBBBBBBBBBBBBBBBBBBBBBBBBBBBBBBBBBBBW
WWWWWWWBBBBBBBBBBBBBBBBBBBBBBBBBBBBBBBBBBBBBBBBBBW
WIWWWWWBBBBBBBBBBBBBBBBBBBBBBBBBBBBBBBBBBBBBBBBBBW
WXZBBBBBBBBBBBBBBBBBBBBBBBBBBBBBBBBBBBBBBBBBBBBBBW
WBBBBBBBBBBBBBBBBBBBBBIBBIBBBBBBBBBBBBBBBBBBBBBBBW
WBBBBBBBBBBBBBBBBBBBBBBIIBBBBBBBBBBBBBBBBBBBBBBBBW
WBBBBBBBBBBBBBBBBBBBBBIBBIBBBBBBBBBBBBBBBBBBBBBBBW
WBBBBBBBBBBBBBBBBBBBBBWWWWBBBBBBBBBBBBBBBBBBBBBBBW
W         X            WW            X           W
WBBBBBBBBBBBBBBBBBBBBBBWWBBBBBBBBBBBBBBBBBBBBBBBBW
WBBBBBBBBBBBBBBBBBBBBBBWWBBBBBBBBBBBBBBBBBBBBBBBBW
WBBBBBBBBBBBBBBBBBBBBBBWWBBBBBBBBBBBBBBBBBBBBBBBBW
W         X            WW            X           W
WBBBBBBBBBBBBBBBBBBBBBBWWBBBBBBBBBBBBBBBBBBBBBBBBW
WBBBBBBBBBBBBBBBBBBBBBBWWBBBBBBBBBBBBBBBBBBBBBBBBW
WBBBBBBBBBBBBBBBBBBBBBBWWBBBBBBBBBBBBBBBBBBBBBBBBW
W         X            WW            X           W
WBBBBBBBBBBBBBBBBBBBBBBWWBBBBBBBBBBBBBBBBBBBBBBBBW
WBBBBBBBBBBBBBBBBBBBBBWWWWBBBBBBBBBBBBBBBBBBBBBBBW
WBBBBBBBBBBBBBBBBBBBBBBBBBBBBBBBBBBBBBBBBBBBBBBBBW
WBBBBBBBBBBBBBBBBBBBBBBBBBBBBBBBBBBBBBBBBBBBBBBBBW
WBBBBBBBBIBBBBBBBBBBBBBBBBBBZZZZZZZZZZZBBBBBBBBBBW
WBBBBBBBBIBBBBBBBBBBBBBBBBBBBBBBBBBBZBBBBBBBBBBBBW
WBBBBBBBBIBBBBBBBBBBBBBBBBBBBBBBBBZBBBBBBBBBBBBBBW
WBBBBBBBBIBBBBBBBBBBBBBBBBBBBBBBZBBBBBBBBBBBBBBBBW
WBBBBBBBBIBBBBBBBBBBBBBBBBBBBBZBBBBBBBBBBBBBBBBBBW
WBBBBBBBBIIIIIIIIIBBBBBBBBBBZZZZZZZZZZZBBBBBBBBBBW
WBBBBBBBBBBBBBBBBBBBBBBBBBBBBBBBBBBBBBBBBBBBBBBBBW
WBBBBBBBBBBBBBBBBBBBBBBBBBBBBBBBBBBBBBBBBBBBBBBBBW
WBBBBBBBBBBBBBBBBBBBBBBBBBBBBBBBBBBBBBBBBBBBBBBBBW
WBBBBBBBBBBBBBBBBBBBBBBBBBBBBBBBBBBBBBBBBBBBBBBBBW
WEBBBBBBBBBBBBBBBBBBBBBBBBBBBBBBBBBBBBBBBBBBBBBBEW
WWWWWWWWWWWWWWWWWWWWWWWWWWWWWWWWWWWWWWWWWWWWWWWWWW
