
WWWWWWWWWWWWWWWWWWWWWWWWWWWWWWWWWWWWWWWWWWWWWWWWWW
WXXXXXXWBBBBBBBBBBEBBBBBIIBBBBBEBBBBBBBBBBWXXXXXXW
W  XX  WBBBBBBBBBBBBWWWZIIZWWWBBBBBBBBBBBBW  XX  W
WXXXXXXWBBBBBBBBBBBBBBWZWWZWBBBBBBBBBBBBBBWXXXXXXW
WWWWWWWWBBBBBBBBBBBBBBWZWWZWBBBBBBBBBBBBBBWWWWWWWW
WBBBBBBBBBBBBBBBBBBBWBBBWWBBBWBBBBBBBBBBBBBBBBBBBW
WWWWWWWWWWWWWWWWWWWWWWWBWWBWWWWWWWWWWWWWWWWWWWWWWW
WBBBBBBBBBBBBBBBXWWWBBBBWWBBBZ ZZZBBBZBBBZBBBBBBBW
WBBBBBBBBBBBBBBBBBBBBWWWWWWWWBBBBBBBBZBZBZBZBBBBBW
WBBBBBBBBBBBBBBBXWBWWWWWWW  Z       BZBZBZIZBBBBBW
WBBBBBBBBBBBBBBWWWBBBBBBWWZZBZZZZZZZZZBZBZBZBBBBBW
WZWX           WWW  X   WWZZBZZZZZZZZZBZIZBZBBBBZW
WZW    X       WWWBBBBBBWWBBBBBBBBBBBZBZBZBZBBBBZW
WZW        X   WWWBBIIBBWWBBBBBBBBBBBZBZBZBZBBBBZW
WBBBBBBBBBBBBBBWWWBBBBBBWWBBBBBBBBBBBBBZBBBZBBBBBW
WBWWWWWWWWWWWWWWWWWWWWWWWWWWWWWWWWWWWWWWWWWWWWWWBW
WBBBIBBBBBBBBBBBBBBBBBBBBBBBBBBBBBBBBBBBBBBBBIBBBW
WBBBBBBBBBBBBBBBBBBBBBBBZZBBBBBBBBBBBBBBBBBBBBBBBW
WWWWBBBBBBBBBBBBBBBBBBBBIIBBBBBBBBBBBBBBBBBBBBWWWW
WBBBBBBBZBBBBBBBBBBBBBBWBBWBBBBBBBBBBBBBBBBBBBBBBW
WBBBBBBZIZBBBBBBBBBBWWWZWWZWWWBBBBBBBBBBBBZBBBZBBW
WBBBBBBBZBBBBBBBBBBBBBWZWWZWBBBBBBBBBBBBBBBBBBBBBW
WBBBBBBBBBBBBBBBBBBBBBWZWWZWBBBBBBBBBBBW    X    W
WBBBBBBBBBBBBBBBBBBBWBBBWWBBBWBBBBBBBBBWBBBBIBBBBW
WWWWWWWWWWWWWWWWWWWWWWWBWWBWWWWWWWWWWWWWWWWWWWWWWW
WBBBBBBBBBBBBBBB  ZBBBBBWWBBBBBBBBBBBBBBBBBBBBBBBW
WBBBZBBBBBBBBBBBBBZWWWWWWWWWWBBBBBBBBBBBBBBBBBBBBW
WZZZBZZZZZZZZZZZZZWZZZZZWWBBBBBBBBBBBWWWWWWWWWWWWW
WZZZBZZZZZZZZZZZZZZZZZZZWW    X      WBBBBBBBBBBBW
WZBBBBBBBBBBBBBBBBBBBBBBWWBBBBBBBBBBBWBW   X   BZW
WZBBBBBBBBBBBBBBBBBBBBBBWWBBBBBBBBBBBWBWBBBBBBBBZW
WZBBBBBBBBBBBBBBBBBBBBBBWWBBBBBBBBBBBWBWBBBBBBBBZW
WBBBBBBBBBBBBBBBBBBBBBBBWWBBBBBBBBBBBBBWBBBBBBBBBW
WBWWWWWWWWWWWWWWWWWWWWWWWWWWWWWWWWWWWWWWWWWWWWWWBW
WBBBBBBBBBBBBBBBBBBBBBBBBBBBBBBBBBBBBBBBBBBBBBBBBW
WWWWBBBBBBBBBBBBBBBBBBBBBBBBBBBBBBBBBBBBBBBBBBWWWW
WBBBBBBBBBBBBBBBBBBBZ   X    ZBBBBBBBBBBBBBBBBBBBW
WBBZBBBBBBBBBBBBBBBBZ        ZBBBBBBBBBBBBBBBBZBBW
WBZIZBBBBBBBBBBBBBBBZBBEMIEBBZBBBBBBBBBBBBBBBZIZBW
WWWWWWWWWWWWWWWWWWWWWWWWWWWWWWWWWWWWWWWWWWWWWWWWWW