
WWWWWWWWWWWWWWWWWWWWWWWWWWWWWWWWWWWWWWWWWWWWWWWWWW
WBBBBBBBBBBBZBBBZBBBBBBWIBBBBBBBBZBBBBBBBBBBBBBBBW
WBBBBBBIBBBIBBBBBZBBBZBBBBBBBBZBIBBBBBBBBBBBBBBBBW
WBBZZBBBBBBZBBBBZZBBZZBIBBBZBBBBBBBBBBWBBBBBBBBBBW
WBBIBBBMBBBBZBBZBIZBBBBBBBZBBBBBZBBBBBW    X     W
WBBBBBZBBBBBBZBBBBBBBBIBZIBBBBZBBBBBBBWBBBBBBBBBBW
WBBBBBBBBBBBBBBBBBBBBBBBBBBBBBZBBBBBBBWBBBBBBBBBBW
WWWWWWWWWWWWWWWWWWWWWWWWWWWWWWWWWWWWWWW          W
WWWWWWWWWWWWWWEBBZBBBBBBBZBBBBBBBBBBZBBBBBBBBBBBBW
WWWWWWWWWWWWWWBBZIIBZBBBZZBBZBBBBBZBZBBBBBBBBBBBBW
WWWWWWWWWWWWWWBBBIBBBBIBZBBIZBIZBBBBZBBBBBBBBBBBBW
WWWWWWWWWWWWWWBBBBBZZIBBBIBBZZZZBBBBZBBBBBBBBBBBBW
WWWWWWWWWWWWWWBIZBBBBZZBBZBBZBBBBBBBZBBBBBBBBBBBBW
WWWWWWWWWWWWWWBBBBBBBBBBBBBBIBBBBBBIZBBBBBBBBBBBBW
WWWWWWWWWWWWWWBBBWWWWWWWWWWWWWWWWWWWWWWWWWWWWWWWWW
WBBBBBBBBBBBBBBBBBBBBBBBBBBBBBBBBBBBBBBBBBBBBBBBBW
WBBBBBBBBBBBBBBBBBBBBBBBBBBBBBBBBBBBBBBBBBBBBBBBBW
WBBBBBBBBBBBBBBBBBBBBBBBBBBBBBBBBBBBBBBBBBBBBBBBBW
W          X          III             X          W
WBBBBBBBBBBBBBBBBBBBBBBBBBBBBBBBBBBBBBBBBBBBBBBBBW
WBBBBBBBBBBBBBBBBBBBBBBBBBBBBBBBBBBBBBBBBBBBBBBBBW
WBBBBBBBBBBBBBBBBBBBBBBBBBBBBBBBBBBBBBBBBBBBBBBBBW
WBBBBBBBBBBBBBBBBBBBBBBBBBBBBBBBBBBBBBBBBBBBBBBBBW
W     I    X           I             X    I      W
WBBBBBBBBBBBBBBBBBBBBBBBBBBBBBBBBBBBBBBBBBBBBBBBBW
WBBBBBBBBBBBBBBBBBBBBBBBBBBBBBBBBBBBBBBBBBBBBBBBBW
WBBBBBBBBBBBBBBBBBBBBBBBBBBBBBBBBBBBBBBBBBBBBBBBBW
WBBBBBBBBBBBBBBBBBBBBBBBBBBBBBBBBBBBBBBBBBBBBBBBBW
W     X    I           X             I    X      W
WBBBBBBBBBBBBBBBBBBBBBBBBBBBBBBBBBBBBBBBBBBBBBBBBW
WBBBBBBBBBBBBBBBBBBBBBBBBBBBBBBBBBBBBBBBBBBBBBBBBW
WBBBBBBBBBBBBBBBBBBBBZIIIZBBBBBBBBBBBBBBBBBBBBBBBW
WBBBBBBBBBBBBBBBBBBBBBBBBBBBBBBBBBBBBBBBBBBBBBBBBW
W          X           Z             X           W
WX                    WEW                       XW
W          X                         X           W
WBBBBBBBBBBBBBBBBBBBBBBBBBBBBBBBBBBBBBBBBBBBBBBBBW
WXX   XXXXXXXXXXXX   XXXXXXXXXXXXXXXXX   XXXXXXXXW
WXXXXXXXXXXXXXXXXXXXXXXXXXXXXXXXXXXXXXXXXXXXXXXXXW
WWWWWWWWWWWWWWWWWWWWWWWWWWWWWWWWWWWWWWWWWWWWWWWWWW